################
#           O  #
# O X    #######
####   X       #
#       ########
 ####          #
 #O      X     #
  #  X######## #
   ##      P  O#
     ###########
